Olivia : facebook = F2|7{IZGY1	 twitter = 2HeW{S36GW
Emma : facebook = SACkzDzG	 twitter = 0«K«L8vN
Ava : facebook = FvhJYPR	 twitter = C]E9COQ
Sophia : facebook = 1«VYI7P4<=	 twitter = U16">KZDW1
Isabella : facebook = yV>X7q«Z:3V|	 twitter = FcMUfki908KH
Charlotte : facebook = wU4zV8saLS^A,	 twitter = 2Syxe`nwKPFG8
Amelia : facebook = T9Nh«WI?-c	 twitter = xsR5IxpMNA
Mia : facebook = /TbGEYU	 twitter = JÁRNOoQ
Harper : facebook = IIHfH1f2lP	 twitter = @X21'WCFSl
Evelyn : facebook = elBdF8OUeC	 twitter = GD9R&)KDhr
Abigail : facebook = 8MZL^&A8W9r	 twitter = NOI4hWX6z,$
Emily : facebook = UJxKa6R:«	 twitter = E8JgMUZ:6
Ella : facebook = kQ«CnTSÁ	 twitter = 3TjLWJK6
Elizabeth : facebook = X_*VQ,WG2k>"4	 twitter = d0VSgH&Dz3W"q
Camila : facebook = D7{O«$*Q4O	 twitter = *2O%BrALSq
Luna : facebook = WhDUTH69	 twitter = ÁEaSBCkJ
Sofia : facebook = C4AQRF11`	 twitter = w5SGX_QBv
Avery : facebook = W1UNL8e*J	 twitter = ZHÁfZPUwl
Mila : facebook = LC?38RBB	 twitter = zBdMFJrX
Aria : facebook = <DJ0I"FQ	 twitter = <VJRcUS0
Scarlett : facebook = 4DMPahMw#C63	 twitter = yzxrxBKRT9%E
Penelope : facebook = CL7jK>6L11J0	 twitter = MA6GP00)gE2"
Layla : facebook = WEfs«oXl«	 twitter = «QvoSbOGt
Chloe : facebook = W7TY«)'P#	 twitter = IqRPY)p1«
Victoria : facebook = qX7YucHFJf5z	 twitter = 1-RS8>HC4Mg:
Madison : facebook = YNMs?W#U92[	 twitter = RMcT?Z#«}2b
Eleanor : facebook = "mviBYFDq-W	 twitter = "kUbFN109SF
Grace : facebook = !y1AEO/PL	 twitter = 8YA=4BcKO
Nora : facebook = OHcqDrDU	 twitter = USmkVBnT
Riley : facebook = {XxEJ\SrX	 twitter = dLgRWWHny
Zoey : facebook = OYw&A7«A	 twitter = aeLjUTBW
Hannah : facebook = sNRD)bftLV	 twitter = PO;g)_1«EW
Hazel : facebook = gGFTsuLMl	 twitter = 8XFABP591
Lily : facebook = RD«S>iBy	 twitter = pdEEwWGV
Ellie : facebook = yTiG!1BB«	 twitter = =TBnbMIU!
Violet : facebook = WdBh(dKDD4	 twitter = 6*2R(AE«8E
Lillian : facebook = Á&PRWiroeHW	 twitter = CV4PE69E62]
Zoe : facebook = LUWFNs[	 twitter = O4BnNWI
Stella : facebook = FFR?S15I<4	 twitter = KwV?(ÁTKSn
Aurora : facebook = 5NMSTc09Lo	 twitter = T3fFX«nB?c
Natalie : facebook = ?JxKG@YD0/1	 twitter = Af\hmoJGFT@
Emilia : facebook = 2t1/"UH«AB	 twitter = q2ZYr3ÁZAU
Everly : facebook = )HdSEl.H_B	 twitter = xRWGoAx{bW
Leah : facebook = T47PQZM9	 twitter = F\AZBmSd
Aubrey : facebook = k1R«R99vWT	 twitter = I}wVF2C^1«
Willow : facebook = Y0czAjDM&D	 twitter = QbqFH2duYT
Addison : facebook = bfxYHJXC}xa	 twitter = R5272EZZ1V|
Lucy : facebook = MV1PqfWV	 twitter = UoR%FJ4B
Audrey : facebook = Oyv7Gs9WBB	 twitter = KRQEjm2soG
Bella : facebook = DO870QQIÁ	 twitter = 2CNW1cC|Z
Nova : facebook = FD"UP{Z9	 twitter = VCM3[I*N
Brooklyn : facebook = oTIsucxKF2Zy	 twitter = tSAaQ3C*v`yB
Paisley : facebook = /Z6CXPf1|W&	 twitter = Y2OJh7"o1YO
Savannah : facebook = ,UZx4I,}sUX5	 twitter = wY*.|}K8BqET
Claire : facebook = qZNvT_E«1i	 twitter = &6VT<J6«1E
Skylar : facebook = 5Am+B*A)AW	 twitter = nLMRkA5hU`
Isla : facebook = Z89LQ7GM	 twitter = .gD>CJR«
Genesis : facebook = K-,(uhpJBJS	 twitter = )zBtBYFG|7z
Naomi : facebook = 7ZM%nhNQX	 twitter = QELÁFP3n1
Elena : facebook = iuZx5UUNW	 twitter = SjGIEdG^b
Caroline : facebook = [1I4o:m«UzNV	 twitter = «n24$2FA30QX
Eliana : facebook = PoDXU$n;Ir	 twitter = QVxO;FosMr
Anna : facebook = LV.tcGAS	 twitter = Q=EQgTO6
Maya : facebook = B#gXR6PF	 twitter = P0YxQE0S
Valentina : facebook = Wlu19([OC-9BH	 twitter = 9nyqEo[8RXHT6
Ruby : facebook = TT=KcAGq	 twitter = URSQj5gY
Kennedy : facebook = csZ0kSJ;JJ[	 twitter = &|/SUDWptgT
Ivy : facebook = ZYObOVx	 twitter = HuUBHiZ
Ariana : facebook = Em[DoJLIii	 twitter = «ASl0]Ss@Q
Aaliyah : facebook = .eF21HU[MH:	 twitter = J`BG2.4T4«:
Cora : facebook = vGjP«X(K	 twitter = RfWZe7HJ
Madelyn : facebook = CKo_1Hb3tWJ	 twitter = *qR_X5WQj]C
Alice : facebook = V4xTH1H?P	 twitter = 6kHUiIRCr
Kinsley : facebook = EV9`X#,AC4n	 twitter = II«`o#XLx8&
Hailey : facebook = lOy8GWCXld	 twitter = x*uH7HGrBL
Gabriella : facebook = b9U|SW%]mVMn'	 twitter = O$-U2}WES<ppi
Allison : facebook = LC3#Po`+MO1	 twitter = Z4s0U[qMbX«
Gianna : facebook = tP!3XE1rMU	 twitter = NoDzNE&V^{
Serenity : facebook = W2O72H3qwBtM	 twitter = loW;6z-$GWYD
Samantha : facebook = xEf!5JPÁYS|1	 twitter = n^IQ8KFxg+0C
Sarah : facebook = LbS(7OPS6	 twitter = dTMPR«s51
Autumn : facebook = Q`«P321RY6	 twitter = 8BBK<%Vl0S
Quinn : facebook = uWlrSYlRH	 twitter = QTwJk51MG
Eva : facebook = yYYgNOC	 twitter = bGO?SYR
Piper : facebook = 4STWKQ"/7	 twitter = UEA0fbNU(
Sophie : facebook = x«S;YFN6b;	 twitter = qnwSzOOrIL
Sadie : facebook = CCVCk1ttC	 twitter = Y>1tANUJk
Delilah : facebook = Vpu5BoAIAdy	 twitter = «fKT^lDzVy#
Josephine : facebook = \9SWEz7I#J2v5	 twitter = QZ899#h8A8bWP
Nevaeh : facebook = P«p|p\RfZG	 twitter = r1z|QZZ#PK
Adeline : facebook = jSLL=3U2`Y%	 twitter = 5F|b0VUdLJv
Arya : facebook = JITn[zFI	 twitter = «tDISE9[
Emery : facebook = HU5MO^gFr	 twitter = R5qYUVoX8
Lydia : facebook = JHSK3idQ4	 twitter = J}1fPI/«I
Clara : facebook = 4YOXmZApÁ	 twitter = t6$QIZK'Y
Vivian : facebook = 0IsYKF2uqJ	 twitter = Nq1nWSIeyH
Madeline : facebook = b0A0qqP6HQ«]	 twitter = ?1E15HRG*>:N
Peyton : facebook = J-7|6M7TRZ	 twitter = w-C|MQkUYb
Julia : facebook = O5wOewHAO	 twitter = qHfBpZLV?
Rylee : facebook = «2T'5CLIt	 twitter = HI}O*jDXb
Brielle : facebook = 8:bVW1uU0CI	 twitter = WeKI<5"HG2m
Reagan : facebook = EmRNd«xxI+	 twitter = eHHNFwFzhz
Natalia : facebook = jWEO15H«a_.	 twitter = T3FoZ0p]5UV
Jade : facebook = 27GRPUpQ	 twitter = CQGdZgwR
Athena : facebook = ÁCF3>7i«JW	 twitter = IqU2uZc5FZ
Maria : facebook = K@AZH51{X	 twitter = WZptFFUp3
Leilani : facebook = $w8MTL9k=GK	 twitter = 2c2NU«S*0Pf
Everleigh : facebook = w7nBZ5^B?,NHm	 twitter = cDs9yN^NzM;G1
Liliana : facebook = nVD2&2ZQIyc	 twitter = M8NS&uRsBdz
Melanie : facebook = AgH«oG8"hcC	 twitter = F&DjUN1"2Z|
Mackenzie : facebook = -pSGYPWb4e4g2	 twitter = U6E!8ZJv>N5d6
Hadley : facebook = 4CC«f.=«1X	 twitter = P2%«rTUu,R
Raelynn : facebook = 6OEUP8lf4Xa	 twitter = BbC-97FM0:L
Kaylee : facebook = [E8(VMY:9J	 twitter = L6BsC#Mh4K
Rose : facebook = gMzGNDDb	 twitter = xOuEO7IR
Arianna : facebook = >B9R2N>LrP7	 twitter = mrKsP2zCRR1
Isabelle : facebook = vpb0SK1TY{Hg	 twitter = !rHDTMiDgru@
Melody : facebook = zNyF3«zpEK	 twitter = lPp32OL3EC
Eliza : facebook = 8BWOBB(pu	 twitter = Oy0DME7B2
Lyla : facebook = YÁVÁLPuO	 twitter = UQyrrAPC
Katherine : facebook = _pX«oN2BtrH)$	 twitter = HC=]Yw>,93)GQ
Aubree : facebook = q|1H2HYV9N	 twitter = HES_kzv6LY
Adalynn : facebook = (VlGOWvEz2^	 twitter = I1-C2b"IR2D
Kylie : facebook = d#HJVL4iH	 twitter = T46iQTI1Z
Faith : facebook = ExCDdKeMw	 twitter = FukEpSSmK
Mary : facebook = oRzLH2PG	 twitter = RRoUR8Y|
Margaret : facebook = }9T%1Y(8J6GN	 twitter = ve8YXqJC,J73
Ximena : facebook = 8L8JJ)A&fW	 twitter = fe{fS2«SWS
Iris : facebook = goIAmZAO	 twitter = 2P0C1WTI
Alexandra : facebook = 5Y6X4l}[;uPYF	 twitter = 2;W<)iI6NLDsn
Jasmine : facebook = 2RPPn>HU2c5	 twitter = }=w43N8GOIM
Charlie : facebook = 8sQRZV1/N|:	 twitter = gCZgnwF0ZW2
Amaya : facebook = NYgxJ«H2u	 twitter = ZS2;c"GHM
Taylor : facebook = ZO\0]uSO+X	 twitter = FeB1tLOZ+4
Isabel : facebook = L1&F,T0XM2	 twitter = Y6R}H8UxBs
Ashley : facebook = 'lE9AYC81J	 twitter = LaAxkSqBF9
Khloe : facebook = BLn0FQSxz	 twitter = XWqSCt21B
Ryleigh : facebook = -HUD6JAfcr9	 twitter = -4,XToZLK1a
Alexa : facebook = )B9TG6QW9	 twitter = zOuCVaE1P
Amara : facebook = HbM_qQfTQ	 twitter = DN5v[vWAA
Valeria : facebook = 6a1kMYLD-A,	 twitter = I7"BeEdMaDc
Andrea : facebook = 67C,Q#"RWC	 twitter = >B8elVX"DX
Parker : facebook = Á|Á2MCHWnS	 twitter = 9E"U6qTSX-
Norah : facebook = GG?Hh1TUb	 twitter = ?*?NCZuBD
Eden : facebook = VD?tLPI5	 twitter = zXNHCMo9
Elliana : facebook = 1QONh7rT?To	 twitter = 06P<6(YS?ZI
Brianna : facebook = F4mWJH0«njx	 twitter = x7A+POlV0K&
Emersyn : facebook = RFcHLjG1-7(	 twitter = F26R1CJ{-P(
Valerie : facebook = zQ1D#«eYJ92	 twitter = NKmZ#t351LZ
Anastasia : facebook = A^«T3r*2rE3L'	 twitter = XU"4c3gKq`nJO
Eloise : facebook = ETiY?YaY1h	 twitter = 9^13XHZmJ«
Emerson : facebook = #C]06i5NJXB	 twitter = 4J23_PT60GY
Cecilia : facebook = 3z1*B.pMCVF	 twitter = LSi6p.YJ[En
Remi : facebook = 0PV1R1DT	 twitter = "KIGCFdv
Josie : facebook = 'i.HP2XUS	 twitter = kKRZpQEyn
Alina : facebook = BM#«R"91B	 twitter = WRJ<U"4eO
Reese : facebook = 7KD8FCoEa	 twitter = D«b«wKV*i
Bailey : facebook = B[1TJUHb7f	 twitter = 2V55@HG|GK
Lucia : facebook = L<N[1N3N«	 twitter = 9<VUNeRiN
Adalyn : facebook = fO'oNxEYqU	 twitter = MNKwkVlt2Y
Molly : facebook = EpFL.hY/J	 twitter = H33QI«C1r
Ayla : facebook = «1SLnX4C	 twitter = Tj8GK5QU
Sara : facebook = TtGH8IrI	 twitter = SÁEbQQ/A
Daisy : facebook = pMD«jiXDw	 twitter = qQbT1NwCA
London : facebook = P1LTs=k«(S	 twitter = Fgm«iGaC2Z
Jordyn : facebook = «eZL9<K«i$	 twitter = @ZUmIn1qSD
Esther : facebook = 9jFMyKÁG]W	 twitter = IjGB-ySQ92
Genevieve : facebook = !j(F«10OS@]LÁ	 twitter = pc(ARbiQgaN2R
Harmony : facebook = O[K_9S71OfA	 twitter = 08Y_HIHc2«"
Annabelle : facebook = x}Hs4AHZi.J^,	 twitter = !WÁMVPsrCf$Á,
Alyssa : facebook = X6«BS«ys\o	 twitter = 2|Z«[hAPR4
Ariel : facebook = 0Q^Cb1T«W	 twitter = NCKvMeM$o
Aliyah : facebook = QQ'zNhsHCx	 twitter = E«y'ÁcJIS|
Londyn : facebook = =Brq-DYF1H	 twitter = =5OXa5OUuD
Juliana : facebook = X3I)Kae4XkR	 twitter = uXQGpEo@4X8
Morgan : facebook = U*b>WM5T1D	 twitter = UlÁ0CFRxhV
Summer : facebook = 8FSD4&E=T%	 twitter = +J3SYoCuU2
Juliette : facebook = Q@N«S8D3a#5c	 twitter = a@GXx%W:Á«uO
Trinity : facebook = JURoSc1mgYy	 twitter = "`F«nbVKtWm
Callie : facebook = "WExcPB"Ls	 twitter = qzFÁ50PMXH
Sienna : facebook = YSOsYh7%nW	 twitter = ljOq«AZZ6p
Blakely : facebook = amoQRT/B5_«	 twitter = Q2FMKj//#0I
Alaia : facebook = 98bGIsSVF	 twitter = H{=P_ZY7V
Kayla : facebook = «997E«6WT	 twitter = «RjWE?0$I
Teagan : facebook = CWdTS'Rv9w	 twitter = fNXÁOPkn2I
Alaina : facebook = 1SOaZ«bÁlQ	 twitter = «fjOoPF1V!
Brynlee : facebook = 2G291A/9CJQ	 twitter = AukGaX1AyyE
Finley : facebook = 5TGRO@Y,'|	 twitter = [Ul6Q1DXS4
Catalina : facebook = 4K/0CnNhRfQv	 twitter = nstuH3J_HDyO
Sloane : facebook = 4DP_7S\*II	 twitter = 2WBngB2*GB
Rachel : facebook = Gqd@VcoBHB	 twitter = Ik2rfLXXm«
Lilly : facebook = EgPT*tW8C	 twitter = kCJG*W>*N
Ember : facebook = D9DM8qwMP	 twitter = `r6ZTSfCG
Kimberly : facebook = vO82RC1«O,m1	 twitter = «uaaCWm1T«hy
Juniper : facebook = Y2A9vKyq5YV	 twitter = Vne95O3H|GY
Sydney : facebook = a;CIONuJz3	 twitter = S;f1P2VNBÁ
Arabella : facebook = EiY8cmYH)omX	 twitter = xS6&DH+jIn«n
Gemma : facebook = N75UJX=]Z	 twitter = F5d1DIfMD
Jocelyn : facebook = LDTH17<I]@l	 twitter = jdDPbPwtYDm
Freya : facebook = 9nHPX0L2N	 twitter = :$SEdJKN>
June : facebook = EIMV8t,X	 twitter = OTk5KIRq
Lauren : facebook = 3F4N08,ITE	 twitter = 2«)U!uIPNa
Amy : facebook = NnXjPZS	 twitter = «nHBLF'
Presley : facebook = Á1gwU"R««pW	 twitter = `aVQKrSj«cp
Georgia : facebook = -RrL6Nl(CEz	 twitter = WjMCxsjKbnR
Journee : facebook = z9NFPn1lUpW	 twitter = T83KuMNuw5D
Elise : facebook = p1kCBaGLE	 twitter = \zNFIaeWS
Rosalie : facebook = GtdX8UtP0uV	 twitter = 5U2bdTKQcOi
Ada : facebook = UEI7sWW	 twitter = KSHzEuR
Laila : facebook = PJPajNSs6	 twitter = B8V1iFHRq
Brooke : facebook = RRhz*e1RJH	 twitter = ZD{UoM=/Xv
Diana : facebook = A8JIP3dzT	 twitter = bOPR4JF40
Olive : facebook = GAQÁhJe7H	 twitter = MHKZm<5Np
River : facebook = }PzN8MRLo	 twitter = VS*h1DDIm
Payton : facebook = P(p«Wye0VM	 twitter = GK{|DW*Pog
Ariella : facebook = UH1/'2L@TVr	 twitter = 1JXa2JwC3;J
Daniela : facebook = :lTFOszJMtr	 twitter = VdID4P[R8>o
Raegan : facebook = PqPG2fB$!D	 twitter = «IKaug}BTh
Alayna : facebook = >KFQ;GvN"g	 twitter = ZS_MHQml0g
Gracie : facebook = T[GMZvjrcR	 twitter = mS!VZwu$NJ
Mya : facebook = B:IPL*F	 twitter = XVC9H*E
Blake : facebook = [8XJEK\L6	 twitter = vyQRlNJ%J
Noelle : facebook = 4YvA=EP;*T	 twitter = EPNj=auJXh
Ana : facebook = FJ7lEFS	 twitter = PPMaQcD
Leila : facebook = hFsSÁRiYP	 twitter = JB6FlOA&6
Paige : facebook = GHcdNIhVj	 twitter = QF04WAwÁQ
Lila : facebook = aXaFJSSu	 twitter = mCAShmJQ
Nicole : facebook = .B1)EhYfKJ	 twitter = RV=)zyiHHR
Rowan : facebook = 4CHpHA>sA	 twitter = r«qGDpDE-
Hope : facebook = XtV«ifCU	 twitter = 8LXD1WzS
Ruth : facebook = FWNNqsU6	 twitter = YHZ]8ZPb
Alana : facebook = Zh-hmBTMB	 twitter = 29W«Kw1IN
Selena : facebook = 8CGvd+ACUi	 twitter = «vOIYw9Q-7
Marley : facebook = V`1Q%IU!/T	 twitter = uJa.ZTQiZ9
Kamila : facebook = hJRiHK=pmW	 twitter = «?L'1TWO9+
Alexis : facebook = GTw=P)esSU	 twitter = 7F1kF)!LRD
Mckenzie : facebook = Qde2E#/KYrWw	 twitter = x2TbK8YEv{%L
Zara : facebook = EqNj1IZM	 twitter = «AXzj4WN
Millie : facebook = DvqGW5YXm.	 twitter = 22adRM8NQW
Magnolia : facebook = EvbN!«R.P94=	 twitter = IHx6GGI2rg9=
Kali : facebook = «lh«QiQB	 twitter = pjS9MSDX
Kehlani : facebook = MKeP/hk2$WG	 twitter = <5OHtQN2l3F
Catherine : facebook = vX)a-'|OtSVG0	 twitter = kW)tmABTNn4b3
Maeve : facebook = N_DtGiEEy	 twitter = 1X8VI@6VO
Adelyn : facebook = 2zmGQSDlT1	 twitter = RML%2YwU54
Sawyer : facebook = GNQ8aT}Vmb	 twitter = F/mOm2AG2K
Elsie : facebook = 0FJ6EH.{G	 twitter = B/AZMfsXd
Lola : facebook = lyFKTM8Q	 twitter = 95WOYXS/
Jayla : facebook = vHADH1mvF	 twitter = CUX^cK7Ad
Adriana : facebook = b«YwY0Pe1/E	 twitter = JBs*M1u4PH{
Journey : facebook = S?P7DC_]N+6	 twitter = Ny@EUs_oYuA
Vera : facebook = R«WtwTK4	 twitter = WX«gTrMn
Aspen : facebook = 21-SUYFK0	 twitter = 1VBRUwz!Q
Joanna : facebook = 6CYN)SP51j	 twitter = ?LuQHtn1QT
Alivia : facebook = kYAAr%vXIw	 twitter = V6nIUG10{Y
Angela : facebook = AT:Z7WC)&6	 twitter = qpsGClGZlW
Dakota : facebook = 8T,LlLQ"Dd	 twitter = 3:QxK1_KA«
Camille : facebook = 8Yn^_SQ5eFP	 twitter = NYFFlS0o2,[
Nyla : facebook = PK?iLSV5	 twitter = n-«GzWSN
Tessa : facebook = ysNz,MOOB	 twitter = 0GX4tNNRv
Brooklynn : facebook = ;S1SCÁMr>K092	 twitter = rD'pSB\R0f_C>
Malia : facebook = 1R{EpNcVX	 twitter = uzCsLPB{I
Makayla : facebook = Ycl4p3EATOt	 twitter = }j!NSgFNyFr
Rebecca : facebook = rrDEuaBmYjO	 twitter = wPcYrO3%I8V
Fiona : facebook = NBX2«o?«f	 twitter = UCAXrf6Of
Mariana : facebook = (P"hIcOW0cT	 twitter = wNN1ÁJ5C;6Y
Lena : facebook = OAPElYn6	 twitter = /HA6RBG'
Julianna : facebook = ABp3{cK6MxzV	 twitter = 8;mCgIPiGQ!<
Vanessa : facebook = KhG9eSyUUqi	 twitter = 8oge0HDWUZf
Juliet : facebook = UaM8X^NaaH	 twitter = Nb7T0LVSz*
Camilla : facebook = hcDyBCQiQzi	 twitter = BZ+l«P3G1e-
Kendall : facebook = L30G_=L\W'I	 twitter = L4Rz_H491NV
Harley : facebook = "2Nu«SnB6«	 twitter = pnKMTaW04K
Cali : facebook = OZuoUXKa	 twitter = JXFm9JdE
Evangeline : facebook = 2CfgdK,LAnFxy7	 twitter = zuZfJq1'«BabD$
Mariah : facebook = %HLG8{Ko(S	 twitter = J1Hz`G9BU%
Jane : facebook = IzpPTHoG	 twitter = NDyO@XMn
Zuri : facebook = D5FG0MÁA	 twitter = hQ3KuERY
Elaina : facebook = PUOYo;8D'e	 twitter = YZ1EfmS4lF
Sage : facebook = S;rMR7JR	 twitter = tFH0BIX4
Amira : facebook = YxsoOUPpT	 twitter = FRY=iGKÁr
Adaline : facebook = Z1tgVP4#+ZB	 twitter = BMf1NTGxr"0
Lia : facebook = WURpFqW	 twitter = AxKY1ZI
Charlee : facebook = 4hR[rkOJIW7	 twitter = mDN1o$ID«!n
Delaney : facebook = 1J0VZhQMe'0	 twitter = nW3G2fyPlTM
Lilah : facebook = ltMCurJED	 twitter = RNcx3EB{K
Miriam : facebook = 3UL=?SHtA8	 twitter = wB«7tJGM9s
Angelina : facebook = oQSZL7'bt`H9	 twitter = CHW}6O'?4pnC
Mckenna : facebook = W«Fd14r8^PV	 twitter = PQ%ynNYMvk7
Aniyah : facebook = Ap6OR&O!Yc	 twitter = X/L14P9HC5
Phoebe : facebook = AJOQ270gFk	 twitter = DkbB81VViA
Michelle : facebook = T-uh+O4kTX\H	 twitter = Co5"+FX0K+kE
Thea : facebook = pSF6LGOÁ	 twitter = kqRG0RXF
Hayden : facebook = bcWRS>V9Lf	 twitter = N{EfW>1WrT
Maggie : facebook = 7PH7F0mYN1	 twitter = @izFRlE&GJ
Lucille : facebook = JTV-1GybV9'	 twitter = G«E-L«6,wr1
Amiyah : facebook = NN1JMuZbsb	 twitter = Hc*HcMhX1P
Annie : facebook = DG9Z"RzRc	 twitter = vXQ)T!HS7
Alexandria : facebook = yrC/e;;EUMbrB4	 twitter = w[ef;VUlmoTmXK
Myla : facebook = KkZZQFaa	 twitter = JUx1W1BN
Vivienne : facebook = {WvL{dO&DnU8	 twitter = jgRIJ%"E%g7O
Kiara : facebook = PGuC«a1yP	 twitter = MkpoH9«RU
Alani : facebook = Vx|B;TISc	 twitter = W.Cn«f\OY
Margot : facebook = Ub1GM$NO3|	 twitter = VYqqAtQS2u
Adelaide : facebook = "x^X5O8«KUms	 twitter = 9E^1C2]L*gCX
Briella : facebook = A-0TXRf15sB	 twitter = IC63]5WAF1>
Brynn : facebook = GFmS3a8ZC	 twitter = 1JZfyJnIR
Saylor : facebook = wXOP#YC17h	 twitter = 5Q7Xo6CSCÁ
Destiny : facebook = 7_|T68UJB1A	 twitter = X_H:eNHl81M
Amari : facebook = ÁXS:k0YHZ	 twitter = O1jHT"-LO
Evelynn : facebook = z1El92NNEyK	 twitter = UA4IW?qof@K
Haven : facebook = Q9IU}HE*x	 twitter = 174vWZI«R
Phoenix : facebook = mE#VTv6YxL1	 twitter = %LPGN1Kju@r
Izabella : facebook = |N1"Vt6ÁZ2RZ	 twitter = 1Nv"Uw9bN*UC
Kaia : facebook = FLYvIdnB	 twitter = Q1TSPTze
Lilliana : facebook = RN2}0K6&2VmY	 twitter = FwR3TOWeb93i
Harlow : facebook = dyRVwDFbmL	 twitter = FjbPeEnLCd
Alessandra : facebook = 4`]%711CICQ4cJ	 twitter = :P]G?4$Z`ZL+|n
Madilyn : facebook = "JwN:KbVT47	 twitter = 2_xwFAIEp1P
Nina : facebook = KLLqalVU	 twitter = lK92VQNP
Logan : facebook = FqSTAgAdÁ	 twitter = 5CWF7Pp@Z
Adelynn : facebook = [JY6IRIg12o	 twitter = 1Bm3L7W0E8U
Amina : facebook = h1J1IÁ««Q	 twitter = EUuHs7YK3
Kate : facebook = K2I4EQ_M	 twitter = rGKO8U4B
Fatima : facebook = UtV1?ePqBG	 twitter = E6UM?2UeJ{
Samara : facebook = ÁZ>apFKULk	 twitter = uBezeCW*YC
Winter : facebook = 9OqYUv_CoR	 twitter = WDr&iOUÁ2P
Giselle : facebook = (1CHLQL:54@	 twitter = GEZnZ/dz1cC
Evie : facebook = iyEUKLgX	 twitter = u0XB«fLT
Arielle : facebook = 1Dw^ZB2p«t«	 twitter = tEaON61KoJq
Jessica : facebook = ^QNDQ@8M"26	 twitter = 90M1WEJ^"1R
Talia : facebook = DwrQ_YETt	 twitter = pB5<EWXYu
Leia : facebook = P.Y-HeGE	 twitter = CIWJC"dj
Gabriela : facebook = 1M5G)9bz'DGX	 twitter = MBKCg_{3r#W1
Gracelyn : facebook = BNsS82kK%2rU	 twitter = 'Q.G0n-3NPM3
Lexi : facebook = 8W5VIPAc	 twitter = TG«r«k2S
Laura : facebook = Vu3L«FE0\	 twitter = /YGy5XZDr
Makenzie : facebook = AAmyVQwRuyÁi	 twitter = 2C8F9I&1Am8Q
Melissa : facebook = 4TB2-BX3B%1	 twitter = kJQHYp/;U46
Royalty : facebook = Dl"L;iKZkH%	 twitter = Uxl$nC/YD.P
Rylie : facebook = ;W4ySSXQm	 twitter = z+y'BVEPE
Raelyn : facebook = &F[[^VGA1A	 twitter = 60[UTBV2Il
Gabrielle : facebook = =X7TMGH0'3$;1	 twitter = OE56HAv['F$9m
Paris : facebook = wM1OMzPe«	 twitter = 8E««SK#66
Daleyza : facebook = 1&rnMPWm2YM	 twitter = l«dCZAy],#K
Joy : facebook = W7iRHDB	 twitter = X6JgUZL
Maisie : facebook = G«OJk2T03(	 twitter = W'n12IDSN(
Oakley : facebook = KMV|1aK8J)	 twitter = k!K7FO0cNY
Ariyah : facebook = WhILCfHeil	 twitter = Y0R{|&jKEK
Kailani : facebook = LO10Ja36NyT	 twitter = 4S\64COTO_'
Alayah : facebook = Du9dÁLT1IJ	 twitter = VW,joGZzX9
Stephanie : facebook = [NC8;&G^\1HJ`	 twitter = B!M^9vAJ7m^5R
Amora : facebook = vsHGHqY/Q	 twitter = w«gZN1W/«
Willa : facebook = ]EvLaV/TL	 twitter = SdEDQaZ%+
Gracelynn : facebook = 17>Eb3C4}CY}P	 twitter = JXZ2uF5`J<qi]
Elle : facebook = T9HÁkTCX	 twitter = YcZV«Wmi
Keira : facebook = cCW15OIG9	 twitter = lK_oKLNS|
Tatum : facebook = VAhBweG:B	 twitter = kAD$QO1I;
Veronica : facebook = ?0H>AXC0}J:2	 twitter = C3cM[&mQJo:H
Milani : facebook = HFK3Otq5He	 twitter = 2bsBx«-RSS
Felicity : facebook = 4XX|ri3FTfP,	 twitter = SA5T(8xH1;_Q
Paislee : facebook = Dn5J;0CZE16	 twitter = ;nGOrh«zALq
Allie : facebook = vGvNAÁjLZ	 twitter = d4qZBVU&U
Nylah : facebook = 9T1F2SHU,	 twitter = Up4T«Sv1I
Ariah : facebook = dCBiRkL,J	 twitter = 1TJ«L(Y,r
Cassidy : facebook = v|4''"CKHJK	 twitter = {BBKZT0:2;8
Lyric : facebook = DC3VtpvXJ	 twitter = gToHbZX6I
Madeleine : facebook = ?t[Aj(L2YG2H8	 twitter = Wj19PXT}1_7I8
Miracle : facebook = 0X8FgYkIQ74	 twitter = AKk;QaP1pjI
Gwendolyn : facebook = oÁr94«2KxuRNW	 twitter = 9>IAQi[$v2JÁT
Octavia : facebook = N2bpTi«48HB	 twitter = 2SI88#UD[Z*
Dahlia : facebook = >*2BP4WwBB	 twitter = 1M3Rh7C3CD
Heidi : facebook = JziVkZSYw	 twitter = Mx«vZwZIg
Celeste : facebook = o&D!Oa6VPHi	 twitter = F&V2tDp\NP4
Remington : facebook = x61UMnJ5?A7_F	 twitter = 2Sl>$6&8y«HRJ
Makenna : facebook = R?tCAwmZ-xM	 twitter = eTAy`MeT1Aj
Everlee : facebook = s<#NXYK[H=<	 twitter = ZNZ8G1ÁM3=j
Scarlet : facebook = '7_XSAQ1r^B	 twitter = JmBBu!P2Xo#
Esmeralda : facebook = UM52P",G.H1%/	 twitter = E|j+4AHeFG]82
Maci : facebook = RnXFUvTt	 twitter = cWKGy}«S
Lainey : facebook = DM1eB7«-G6	 twitter = QJ8D)a$mGP
Jacqueline : facebook = ZT_2r)TI«nk*<=	 twitter = ETYp;j^D5a/Tb6
Kira : facebook = GKRSv=Kd	 twitter = TzfJqQOA
Lana : facebook = p\L7GOYQ	 twitter = OV5yR4EP
Brinley : facebook = _Lsj'7UPAvO	 twitter = C,QN'uBÁP|6
Demi : facebook = MZAorIUl	 twitter = ;JszAGQR
Ophelia : facebook = YC2#L&|Z&Cv	 twitter = vjPLz«qViC=
Lennon : facebook = JMQd2S5M06	 twitter = ;z}NEKWBi!
Reign : facebook = _9MXhU/WX	 twitter = NQcVHFy|u
Bristol : facebook = 15KuS}"BG9F	 twitter = C#78%tCE3ZO
Sabrina : facebook = +zE:lVoC0UA	 twitter = 21LSXgJ}P(8
Alaya : facebook = RzE1RCa1O	 twitter = CKNPc6sP+
Jennifer : facebook = S0wE0MU?h«b'	 twitter = 28^R^TZ«r<6W
Kenzie : facebook = ,N8H0MV{6H	 twitter = PC5IR0J{96
Angel : facebook = Q2QA0cCXn	 twitter = OEJvfSxDm
Luciana : facebook = «RmO7f«N,82	 twitter = gEJbp6.^Q«S
Anaya : facebook = ZIQAoÁk!T	 twitter = HT1*RSy6N
Hallie : facebook = «gdU0WPF9n	 twitter = YR3ZH,1"9A
Ryan : facebook = LC7F{BTj	 twitter = «GIt{qYC
Camryn : facebook = N«;lDheN0A	 twitter = P6dVB45XrM
Kinley : facebook = Z0I«cWpoM.	 twitter = JJ2Á[BLvE.
Daniella : facebook = s'M-«aUL165W	 twitter = hHtV2RP$+#X=
Lilith : facebook = Ya1PaQZeMc	 twitter = XT9p[r0CAJ
Blair : facebook = dWAI7UW85	 twitter = TmRJQFhiy
Amanda : facebook = ULXbviCÁ4C	 twitter = M5T|pI1xZX
Collins : facebook = 8rK6B-«HiK.	 twitter = g0IQUHbp@0Z
Jordan : facebook = lwG.E«hE!Z	 twitter = YiO8MVlrIu
Maliyah : facebook = ÁEhE1Xk\6QT	 twitter = Z`]#1ÁL0VQN
Rosemary : facebook = vzQAroiI2M2Q	 twitter = FQI..Q43Sf)d
Cataleya : facebook = M#[sRC`Lk1C@	 twitter = 5D[XZWk[C7.2
Kaylani : facebook = Q+IjaK4uGVz	 twitter = kr9r_1EFHZI
Gia : facebook = VHsH]OU	 twitter = 0EDY]ZT
Alison : facebook = 4$VUKMr)LÁ	 twitter = 7L`ZV1msG«
Leighton : facebook = Urz2kMaKXF#7	 twitter = 3V0Vf:U4>ZE1
Nadia : facebook = pI8+JAM5D	 twitter = NUM6dB-wW
Sutton : facebook = P*|0UD9Pk«	 twitter = ZU|CX"zoU0
Carolina : facebook = 0/BdqTuj1ORJ	 twitter = ;/MNB62!Uv2R
Skye : facebook = UDFz4SkL	 twitter = GuTBVB5<
Alicia : facebook = SV11v'0HRD	 twitter = «d51ZPE#W8
Regina : facebook = v7U8IV*N2F	 twitter = sWFTnSrIvd
Viviana : facebook = lS47OFtD"U-	 twitter = YTeIBN1662-
Yaretzi : facebook = *S{->S#I1PD	 twitter = WMM5>\11TX5
Heaven : facebook = KK1q5yPDW%	 twitter = %VrUS2JOdÁ
Serena : facebook = Tl«UGj2{3C	 twitter = w|:EQkrBBE
Raven : facebook = Q9gQtU*KR	 twitter = OmbaRN«2O
Emely : facebook = QRvÁLGwiQ	 twitter = AIxuCsPFk
Carmen : facebook = kSBC':96SQ	 twitter = #EMBD1Z,a4
Wren : facebook = ZT3GMdGq	 twitter = CHsÁMVyA
Helen : facebook = Y)W5M)V1F	 twitter = XT4K7)TOÁ
Charleigh : facebook = _TOyF-y2>3N6M	 twitter = NO.KMd`5>=Dp|
Danielle : facebook = mKlrJO_pxH\P	 twitter = )Y0v2VX2TXq0
Daphne : facebook = ;e+PZROBw9	 twitter = 2"Q+XTxXV8
Esme : facebook = MrQL00PI	 twitter = XJgR1QUz
Nayeli : facebook = 90Q^wHH5SH	 twitter = aJ«sVroV1C
Maddison : facebook = nRX8cExNh1-U	 twitter = >DWrV.(Su9L6
Sarai : facebook = cqHVURFmw	 twitter = .GO6E4HCp
Dylan : facebook = wTQZqiZnZ	 twitter = 1jDV1MoKB
Frances : facebook = BA'#/1L«p5S	 twitter = F-0#CVriyXG
Elisa : facebook = C6wA.HW)V	 twitter = BOgR.C9Ih
Mabel : facebook = HKkL1«?7J	 twitter = gMZFqEsIs
Skyler : facebook = |g8$WKXHxP	 twitter = H7J21P-N0«
Jenna : facebook = _EEK7vNsJ	 twitter = gQOoZK6Iy
Emelia : facebook = K-t0TVnXuI	 twitter = gIIJ_D^Y1Á
Kaitlyn : facebook = [AZJ_1ip]XA	 twitter = AWUwJeCw][@
Miranda : facebook = )4X0KW!KW\+	 twitter = 0Z2NYo!MV\+
Marlee : facebook = RPFsBD23mf	 twitter = qidK:B/AOC
Matilda : facebook = Uo@8P9IP4oW	 twitter = Tb9,A5O7X}G
Selah : facebook = I,HF[8+AX	 twitter = P21DTJ+P#
Jolene : facebook = o*Uj3EH«D4	 twitter = Bi0«sWFqoA
Wynter : facebook = 0iQRqCU_?I	 twitter = JkDB5FxRol
Hattie : facebook = S3n+S;MB7B	 twitter = GJ5AUw@u5«
Bianca : facebook = CX&lJrS28O	 twitter = EMKcOn!,Au
Haley : facebook = P6pP6LN<Y	 twitter = KhE1Z5T0E
Lorelei : facebook = >5V1AZ517BU	 twitter = >3Q-*BR1Q8J
Mira : facebook = UGVRseLd	 twitter = VSL9cJJw
Braelynn : facebook = 1rmBQO.T"zyO	 twitter = 1dM}BS.Td6Nx
Annalise : facebook = Fd69#J1d8WSW	 twitter = OZoUsHlw9c«l
Madelynn : facebook = yA+8x#XvJqR«	 twitter = s#E%U6SZgx2O
Katie : facebook = zpK3QCWD/	 twitter = @kEQ4DKA0
Palmer : facebook = 0Gn5«CT3vG	 twitter = Ku$$UU7HN2
Aylin : facebook = 6yKd9DJBR	 twitter = 2AHK{|QhX
Elliott : facebook = FN^WK7«10en	 twitter = NF^01JdE9Vn
Kyla : facebook = tVUJ2EQe	 twitter = «WV_KqDx
Rory : facebook = zKVjIfEM	 twitter = jnVXD3«B
Avianna : facebook = *mpFJHÁ9hEE	 twitter = J*`CGX35R&9
Liana : facebook = 0A7JJe6EK	 twitter = SmUYdLChz
Shiloh : facebook = 9JHI1_0Z8U	 twitter = ÁUPgmX<uCD
Kalani : facebook = 1>NL_Q3wLT	 twitter = HD5`DG7^S1
Jada : facebook = OIeNRQ8+	 twitter = IMWxU|-L
Kelsey : facebook = ÁGSP6FqE,f	 twitter = P12M.6«IA2
Elianna : facebook = I59IQq&UQ#9	 twitter = '4TvCBwS##G
Jimena : facebook = s@dSLsZtPF	 twitter = LKeH4E8i7G
Kora : facebook = KP&jEOJn	 twitter = «p5C>ZKK
Kamryn : facebook = j.CD61EJzL	 twitter = fY8Giy«:JR
Ainsley : facebook = 1S*?cZGR0sG	 twitter = 9AiU>Mv@D6A
Averie : facebook = 8U5I1U#NU/	 twitter = KX*G[cSg2T
Kensley : facebook = 2YGIOy0iVs*	 twitter = 0p}NDBhEE@*
Helena : facebook = |FFSxpIQ)j	 twitter = PgcfRHWH0>
Holly : facebook = DGwe«}XsO	 twitter = CJgK«j)8J
Emory : facebook = pÁHQ1Z3HE	 twitter = W]rbSA«Mc
Macie : facebook = CHW|Nz!sD	 twitter = yFPnjE««p
Amber : facebook = YHd3RmJZ}	 twitter = N7=Z%PCA1
Zariah : facebook = XÁRhU5tGaA	 twitter = XeRHTjsdMu
Erin : facebook = RStPlDyW	 twitter = xCzcNBSI
Eve : facebook = UcFYsQR	 twitter = vLGMZU3
Kathryn : facebook = 1qÁ{P«SwtNR	 twitter = LvYXB1f|Llt
Renata : facebook = XjkV48NRO9	 twitter = NpT0xDZN2f
Kayleigh : facebook = S$#XG1r«N>6x	 twitter = Q«nYe#WF214h
Emmy : facebook = PYÁBYCr6	 twitter = nF+'MLMD
Celine : facebook = RTYz9s5%«V	 twitter = oNQimIQ3sH
Francesca : facebook = q[/QX784AGHgs	 twitter = 5[kK$2C60J<KN
Fernanda : facebook = =]88RXMgwTIq	 twitter = =]3pO{}JJ1CS
April : facebook = Z;;TQG|Ld	 twitter = zVGeÁMfME
Shelby : facebook = fJsPZm`DdN	 twitter = VI6K38kuPV
Poppy : facebook = [yabIPJOR	 twitter = fL5,UEVYl
Colette : facebook = LGEgRLpv]aj	 twitter = QOf«}$'6TBi
Meadow : facebook = 3PHT|R9b=F	 twitter = F0jSk3WUoP
Nia : facebook = ApvNSYU	 twitter = wOJCYSn
Sierra : facebook = =P8#TCI0J}	 twitter = sQa#{APTA}
Cheyenne : facebook = O1,7DJNC?242	 twitter = LlH{Jp9oY6B1
Edith : facebook = BqCXQm>=G	 twitter = 1D7UMV>J>
Oaklynn : facebook = CMjWBe11/cI	 twitter = N2Mh#:8IW6L
Kennedi : facebook = "`ZrxeBTNU.	 twitter = sUZSB>8eV;.
Abby : facebook = eYEzQTB0	 twitter = h6ZVSPdA
Danna : facebook = 1MKyr«V2X	 twitter = VrFWM8csD
Jazlyn : facebook = ]bOlkHBsKV	 twitter = ZKrQXHm70a
Alessia : facebook = IN*HM}_a0Z5	 twitter = 0xOUgLrP$q«
Mikayla : facebook = 5E#W7P1-SX@	 twitter = hCEcUlXW._z
Alondra : facebook = 1E7W40=gVOE	 twitter = P2WIsM0.I]n
Addilyn : facebook = U_B|U;20aPN	 twitter = 1ZTj5sTDM<n
Leona : facebook = UC5dUHHd8	 twitter = _1CUQ«I8/
Mckinley : facebook = f!KuUGrxyKoP	 twitter = =V-=eC2AySXf
Carter : facebook = Vo2LY3V1T,	 twitter = HoZg9XPgÁV
Maren : facebook = aEh2KNK%G	 twitter = 1KS«SOfop
Sylvia : facebook = SBMbFLj7g2	 twitter = 3PQOhG0|I#
Alejandra : facebook = H9GaZ{\j&AM^.	 twitter = PuNV$OjgEweq8
Ariya : facebook = MB7ZO0iA2	 twitter = clUMWBLbr
Astrid : facebook = 0W8FVa=S%Z	 twitter = Yf#Hc`RZEp
Adrianna : facebook = K1YG|.3YS8!0	 twitter = xTxMnÁJGZ*!`
Charli : facebook = iÁXkWLMh8H	 twitter = UqXW/R]X15
Imani : facebook = «aHdWh6LQ	 twitter = 5KM40«0BP
Maryam : facebook = }0ElQIb«,R	 twitter = q>1XmLuVJ«
Christina : facebook = o4KKQ21I`K<;<	 twitter = =H16uB}0LGV;z
Stevie : facebook = SAoWaNvPf1	 twitter = t3OBY7cbMA
Maia : facebook = QkZAlFS0	 twitter = WgRA3Z1X
Adelina : facebook = J[k2iQOE&4W	 twitter = tRZww2MxcKF
Dream : facebook = F8xEG0C.G	 twitter = )IÁFaEuMO
Aisha : facebook = 9bPOmE0KG	 twitter = I4WRI3.Le
Alanna : facebook = "xKRlXRTp+	 twitter = PJZ9T]v1E+
Itzel : facebook = Vk?zK8XKY	 twitter = WTRfK}dO7
Azalea : facebook = DKdqFuvLlF	 twitter = S%L;G1L2B5
Katelyn : facebook = JM`4K1RwC^8	 twitter = NQ2-.1GwQO\
Kylee : facebook = HU03PX,Km	 twitter = YEmG.J5H7
Leslie : facebook = FsDp^HRbB7	 twitter = QA]Q0P3H[x
Madilynn : facebook = ?JuJXmI*P{rs	 twitter = RAXZEz2*ox"1
Myra : facebook = .XHVE4tP	 twitter = QFY`Ao7W
Virginia : facebook = ]1QyzLoYQKoy	 twitter = J]epUjnLoE7Q
Remy : facebook = Gbt8EEYP	 twitter = MJpiKUP-
Hanna : facebook = UsWcmWmVU	 twitter = FdWVYtW"s
Aleah : facebook = B«kGFusG{	 twitter = RN<gSZjQj
Jaliyah : facebook = E&mD4P0GZh?	 twitter = _VYST/5u`P1
Antonella : facebook = ^D6HD\&G2P*8#	 twitter = «vcwJPP5/rÁT1
Aviana : facebook = O1IxJv/NgN	 twitter = ÁPLAcMp#Wg
Cameron : facebook = B+J6$OT0bF2	 twitter = mY!mUvBJtrD
Chelsea : facebook = zIClNs«qjzW	 twitter = TOhcHG8O0cc
Cecelia : facebook = JB;O51m2QT7	 twitter = kDsSC7eXq8K
Alia : facebook = 8GKoDKQ0	 twitter = HGV$MpRo
Mae : facebook = E7HKNvK	 twitter = PATh]EN
Cadence : facebook = NK>:7Ry9^HH	 twitter = ISmQO82V^^w
Emberly : facebook = {FPIvQPe3Áy	 twitter = 9.QH[rNY8J]
Charley : facebook = CI@*AOL\\h5	 twitter = {1ZY6XrAC/,
Janelle : facebook = LyOaiKU72F@	 twitter = ?84JfNKV2W6
Mallory : facebook = )OW87-A1O"L	 twitter = 0[WCFD62nnY
Kaliyah : facebook = j}«5O(quBBY	 twitter = Qk[AbI3GuzI
Elaine : facebook = ?LZ30JKL11	 twitter = ?1EJ:G0^NB
Gloria : facebook = oÁRS:ZNj1V	 twitter = KPV:F!*8«7
Jayleen : facebook = n)UksPR1CqX	 twitter = HF41Q'KV8<2
Lorelai : facebook = B6O1-X4uN:R	 twitter = 9OBSByMilva
Malaysia : facebook = Ydau2'oOEOU9	 twitter = ?P16=Q3h,UYM
Bethany : facebook = a5ZjSlnRa«N	 twitter = jI%1BSOB$i8
Briana : facebook = Z1J8A98N;V	 twitter = J$PxyFJ«sn
Beatrice : facebook = =7dHj3%PIM1Z	 twitter = TD5PKf26;F\<
Dorothy : facebook = 1(IgIT«/Cw1	 twitter = ZC"olC{G[#S
Rosie : facebook = GzkP5HkKE	 twitter = ugVLKRRs0
Jemma : facebook = E^1K6BCP[	 twitter = WÁ1CxZREl
Noa : facebook = 6X-ICWM	 twitter = R:«4VAQ
Carly : facebook = gM1RER5)B	 twitter = DbzpAAJkV
Mariam : facebook = F[Y>8F8(GU	 twitter = 3ESO3b=1JC
Anne : facebook = WnZVAG.0	 twitter = 0JQRh`VF
Karina : facebook = IOVa1X.$«g	 twitter = E0Bp$«Sf2S
Emmalyn : facebook = Z«6C4J.0Paa	 twitter = IB4_*JEg+<N
Ivory : facebook = ETyBRqKgs	 twitter = ,ZU16CAkA
Ivanna : facebook = OF0tRoKrmT	 twitter = 3aYClCfYVi
Jamie : facebook = =66DBNMN)	 twitter = gI4X4R1L«
Kara : facebook = IKDmZ9tW	 twitter = rVDTS{1C
Aitana : facebook = 2ZS4zGYjPi	 twitter = Va(TGFJ181
Jayda : facebook = RV«2W1Fxe	 twitter = qSPWCKxld
Justice : facebook = 1,DY0Y61I2Z	 twitter = X,F4?KHueFe
Meredith : facebook = #636«MD+y?HQ	 twitter = MZIC9$gT.20>
Briar : facebook = N66gIH.JY	 twitter = ITWRExvt6
Skyla : facebook = Q41NAQ:S2	 twitter = IIYrs0K6H
Khaleesi : facebook = ZQKoJ@G`194"	 twitter = LEU7s@ax2H,T
Dayana : facebook = 'R3dE3UDWe	 twitter = 0Á9«W\Q9PA
Julieta : facebook = 5>-7F?Q4CXN	 twitter = RX-K3E2@ddN
Katalina : facebook = [$U^xYD8+OB3	 twitter = LTp0c7XST*9t
Kendra : facebook = 4Un0,0ETAF	 twitter = HPRphfftVS
Oaklyn : facebook = XKAKufe$U*	 twitter = T82n2oZSDL
Ashlyn : facebook = 36p<OM1SBU	 twitter = C3hKTDw«z*
Armani : facebook = HvAYezhU9N	 twitter = mXgv«EnXEi
Jazmin : facebook = einlSTT8DR	 twitter = TNYvÁMu2,U
Kyra : facebook = x«]XHC«&	 twitter = M0lVZBE2
Angelica : facebook = O«.UJaG>019n	 twitter = p$B2TZ8H72jW
Zahra : facebook = 4KUMH8O2:	 twitter = 3ÁWMeOdML
Dallas : facebook = FE3tXZ`«k1	 twitter = P9OKLzEv15
Johanna : facebook = EpÁ8&C«U,wA	 twitter = I«2Rr@72OTi
Elliot : facebook = VF1FFeyzG2	 twitter = xYSN5dhcHJ
Macy : facebook = mSLOG2Qn	 twitter = GAuWB,E4
Monroe : facebook = XFUczNisGp	 twitter = 4aSS`PrJDo
Kimber : facebook = 3C*$B*EHB(	 twitter = +1YFW0DlmH
Henley : facebook = OgOC,0H]Y#	 twitter = UAK20L42I#
Ari : facebook = 5RhEJPZ	 twitter = UUJOAcs
Karsyn : facebook = vM#40+YQAT	 twitter = dN5C]+eGOV
Lyanna : facebook = N[«RbaBCcb	 twitter = CiQToNaB2q
Lilian : facebook = tRX2LG92J^	 twitter = Bdw4sO6ATD
Amalia : facebook = MGE%4Uy2B|	 twitter = (1S7ZkYPjR
Nola : facebook = gESdDAtE	 twitter = YqNp6SHQ
Dior : facebook = I8SaSNAg	 twitter = 'DHeBXbD
Aleena : facebook = 0Yh(aaF«PG	 twitter = OmFlELmkY=
Megan : facebook = +ZSNAzp7I	 twitter = cEI4I#1JA
Michaela : facebook = X`A00U@;TAcx	 twitter = 1h[efNfUREjB
Amirah : facebook = SVDI(uke2L	 twitter = QEVkGsBp0p
Cassandra : facebook = aA<A6r*PR$1{U	 twitter = Nz08iarFjBMAw
Melany : facebook = \f1U6XC]JN	 twitter = O44!K0JPeD
Legacy : facebook = fVp1OrwTIZ	 twitter = {L`GBD1nM4
Reyna : facebook = `ÁK(?NSZG	 twitter = `«nMqW0FL
Alma : facebook = r«DAFJ.\	 twitter = LEb4DLR7
Emmie : facebook = VIw«Kg1tL	 twitter = M.KgIaMKg
Melina : facebook = 0«G=K4OJv%	 twitter = M_gVW2L6A%
Siena : facebook = Q8_Z|QM9Y	 twitter = ?ÁcILPTeS
Priscilla : facebook = w+p3VÁMhZ#NuE	 twitter = iDK_H#3lS3S]a
Ashlynn : facebook = 68\vPC[2UPQ	 twitter = <)1P«QAwS'7
Savanna : facebook = yRjoOeTLÁ!G	 twitter = D77^yhEtBJD
Sloan : facebook = "4JB8DQDv	 twitter = xFXRN0Wg+
Tiana : facebook = @DnaBM4NW	 twitter = 0SNd$B$ND
Aubrie : facebook = WMzdIEpAj1	 twitter = mC5TO«1M55
Coraline : facebook = v"MP|He4K5Qh	 twitter = yUC.DZnx82ÁK
Reina : facebook = oHpkSTrYR	 twitter = OoTrVjyKJ
Allyson : facebook = NBlr!DI1h2W	 twitter = MifvSHWE2s3
Kaydence : facebook = LM0d0<)Y8I]J	 twitter = 02Dn0sP6PG]«
Sasha : facebook = ASbF7TN@2	 twitter = GnsCC1NEi
Julie : facebook = bNFI$kAyK	 twitter = VoH*k0MBU
Alexia : facebook = gEIdPG1yE4	 twitter = KajOayHCfZ
Irene : facebook = UY0E20KeW	 twitter = ILx6IhlNA
Marilyn : facebook = Of3DHgCU}|p	 twitter = QO3*U70UF7}
Greta : facebook = /YD`MQu8J	 twitter = dPZKclDI8
Braelyn : facebook = Q2'1REvT[9N	 twitter = CBB4bF8um)B
Emerie : facebook = aZn,V6L,ZO	 twitter = C«:4yjSVmK
Lylah : facebook = 7X1xDL<MR	 twitter = IOc)DJB3q
Nalani : facebook = aQ,LY$E$Q$	 twitter = ARa@Á4IZZk
Monica : facebook = tqU9RQA1«r	 twitter = WgÁZwZ9WTp
Aileen : facebook = U3DMOzpU1p	 twitter = tTtjsRxPAH
Lauryn : facebook = !kI1BEUmT;	 twitter = pA2CS0QUzÁ
Anahi : facebook = IHFo}Y8wT	 twitter = _YQvXSG1f
Aurelia : facebook = Z15ZtUEE0:&	 twitter = KJX«2Y'Áglr
Kassidy : facebook = P_.8I0tFI<X	 twitter = m_«5«M4N/Cy
Rayna : facebook = ADhTjTpjE	 twitter = Ni}«7CMsN
Romina : facebook = MpSb_BLupX	 twitter = 'bNYOVohQ{
Lillie : facebook = RW'V!006QY	 twitter = 2WCV!«obA2
Marie : facebook = RWdt1TYJ1	 twitter = `J7F15WRC
Rosa : facebook = XRbgWpTX	 twitter = xvFCAwCT
Saige : facebook = E«J4+kT3C	 twitter = -Z^TVPÁL8
Bonnie : facebook = JvGug1HZV=	 twitter = XwcO*1«6ZT
Kelly : facebook = bA3VCLJ8"	 twitter = XO0oMaMoG
Xiomara : facebook = SciJSZ}E4^z	 twitter = G'Z"L$T6N^?
Annabella : facebook = >U|N0yGO>pc2W	 twitter = 3G|N)J35Jr:nR
Avah : facebook = JYymACY2	 twitter = GmnhYGGG
Lacey : facebook = 2PU1lRMyN	 twitter = «ZLr0pHeH
Anya : facebook = wK{AJUaH	 twitter = FnA1WX%L
Liberty : facebook = yDPpM2IrI;b	 twitter = A8WY4W@jR;5
Karen : facebook = 9jSXBJ,O\	 twitter = 7##«Jd«DV
Mercy : facebook = VwX1MzpTR	 twitter = P^c`TW?WV
Zelda : facebook = 0CNMw#%LA	 twitter = .J0FK0ZD6
Baylee : facebook = 4Rh92YLAlC	 twitter = 1LVN32Dt"Q
Chaya : facebook = 7JrKQE«l4	 twitter = =BToFwePG
Kenna : facebook = RDlnTDiOq	 twitter = 9BLMD6c5E
Roselyn : facebook = j$E@ET>DMps	 twitter = @W.L6frVSvU
Liv : facebook = VhGD(SP	 twitter = PPDrgCD
Mara : facebook = Á_QzWOMN	 twitter = n00ESTZN
Ensley : facebook = 'I1«pGunJJ	 twitter = J9TÁq;XUjX
Malani : facebook = a3G'M0UZJ|	 twitter = II$1-IRgkD
Malaya : facebook = 3JQ/7VE9B1	 twitter = s0HYP«5Nq2
Hadassah : facebook = pSlÁJAx?R2k«	 twitter = Tx}SKjMIdet1
Lyra : facebook = 8HRpLmBV	 twitter = HQ#4MP0A
Adley : facebook = KkTMiAInk	 twitter = c«8BkOQRp
Galilea : facebook = 4,FME=6Kk6F	 twitter = D8qf8SWhoLB
Jaylah : facebook = JZGzhAxTo`	 twitter = r|LHyWJM6t
Karla : facebook = +OZjRU1hA	 twitter = +1KcVD2CE
Nala : facebook = Mw8KTN«f	 twitter = O3UAYM1?
Opal : facebook = FQIGOx75	 twitter = b[B«QBuY
Aliza : facebook = fK0HwJFG1	 twitter = SWX2E5Bz1
Milena : facebook = s6\WRi,Z«N	 twitter = c2UQ1pKOS6
Ailani : facebook = IljVPYf2pQ	 twitter = ]JPT[Nc8{C
Louisa : facebook = F7-X5eA#OZ	 twitter = oSXF8b^Z=I
Mina : facebook = vXKhlSNG	 twitter = hYE,1DUX
Kairi : facebook = 3X<qGKX8G	 twitter = F5Mw«UuAa
Clementine : facebook = :41'a3HrT0«2PX	 twitter = O36'N1DR<(Y_-)
Louise : facebook = lMqKN@Vj4E	 twitter = SYJoGzwbrC
Maleah : facebook = cR*?PBM7Ez	 twitter = L;1FNG4(J1
Janiyah : facebook = WkEL51I68Yn	 twitter = YW#Á$:2P_UF
Marina : facebook = c1YIQ8#GH"	 twitter = aHI2NU37=V
Anika : facebook = |PJYOr9Bi	 twitter = |wZe}QGKA
Julissa : facebook = J4VY-x&1CC&	 twitter = Yod*QV&Az5H
Bailee : facebook = uEFQ?ZX:1h	 twitter = :DjG6V{:QZ
Hayley : facebook = RXlLv78X0D	 twitter = Csi!WgPOSÁ
Jessie : facebook = mI2ydSSP!P	 twitter = 16j#HEOpOW
Laney : facebook = LfdkSLgEI	 twitter = REB\B8ukX
Eileen : facebook = «)FYRXky21	 twitter = K)NG1t|4WU
Faye : facebook = cESS6M0Q	 twitter = CG3TkyCF
Kynlee : facebook = O03MR0Pa@S	 twitter = «0NYL0{Zg,
Tiffany : facebook = Z85yZNAHm.e	 twitter = QmXEb5F[x3«
Lara : facebook = YGx«6UpG	 twitter = 4OZD84PN
Angie : facebook = w8QRvKHaV	 twitter = CgmrFrFOA
Joelle : facebook = HcCfHf6bYL	 twitter = vAwV%UjiNQ
Rhea : facebook = M8FsETI8	 twitter = A&Y+AD9I
Calliope : facebook = gTN-G3ktRB18	 twitter = rHY7ÁcO2KY7'
Jazmine : facebook = zQOgEox?9BM	 twitter = OnH6fLM5qÁL
Amani : facebook = txXQV8KjV	 twitter = MXbUI5lvY
Haylee : facebook = F5dAo9pDKO	 twitter = 3mvHM;9IVG
Aliana : facebook = <M1nMÁ«SeI	 twitter = 0bwORJbOzQ
Leyla : facebook = We3MKnD0V	 twitter = 51:cAHSEV
Jolie : facebook = jVLRTPj11	 twitter = 2fDV.KR{Q
Kinslee : facebook = T/tw!NC^W2«	 twitter = 9IfBN^%ZHx1
Ryann : facebook = XL3tHozFE	 twitter = HAHmE,«s}
Simone : facebook = Gn«wZOa)Xl	 twitter = 2^SF>QR)E8
Milan : facebook = O6A6KMrP(	 twitter = 4QTNkiUMa
Lennox : facebook = -JO2VkC6Yw	 twitter = 2t`«Z«zmPB
Treasure : facebook = ^NN`1F}O0J{a	 twitter = ^92P{FE/«/I1
Alora : facebook = YFN>,9BBt	 twitter = wUyABB«3w
Ellis : facebook = QPD2hJN:1	 twitter = NNO7ÁF!:A
Rebekah : facebook = ]jf||0ITXEE	 twitter = Al2WCRI3qfl
Mikaela : facebook = xZCVuFcK46g	 twitter = XPehE;pfAoI
Lina : facebook = BDZMYaÁu	 twitter = bYAMaH«5
Harmoni : facebook = CiR#sc#O2HV	 twitter = U6MOxA#Z3z[
Yareli : facebook = P2RBL7P91<	 twitter = <SXRF:jsF4
Giuliana : facebook = QsNw1n^OAJb;	 twitter = 'D"&6DOv7I^Z
Lea : facebook = C0DNYK,	 twitter = G1VdIUN
Harlee : facebook = ,RK/^1VDO4	 twitter = 1PJ6F(1WJp
Elyse : facebook = 9UN4`O«E<	 twitter = iu*XqFIAC
Frida : facebook = obPEiFvIV	 twitter = M4eINTA1f
Blaire : facebook = w1MMMVs>Xi	 twitter = 8W2Z1*QKV6
Aya : facebook = cWRTiPF	 twitter = JRZZZ9s
Laurel : facebook = d^LMo|9ON«	 twitter = &XJS4cyQN2
Meghan : facebook = BG6NW7eD40	 twitter = UdL6KwhQ-M
Pearl : facebook = hD$JfE8OC	 twitter = oHQU0)LBu
Zaylee : facebook = F1:VZ+xJ3T	 twitter = zagCyUFpKD
Alena : facebook = 55lFUU1PZ	 twitter = KMX}5VK<3
Holland : facebook = agILaQcaBGo	 twitter = c_«K9LSZg9s
Bria : facebook = Ui{JF1AQ	 twitter = DI{dCIDj
Rayne : facebook = qnLBQeEJo	 twitter = SMEa8}ZM2
Bridget : facebook = xUNGMvy"M>u	 twitter = MyÁjT|VsKvC
Zariyah : facebook = G9HN2.a%H5V	 twitter = c+S!"jUK[BA
Kori : facebook = [CyPYR0F	 twitter = [SXO5zRH
Frankie : facebook = 6k:QaGR2BD[	 twitter = DeH2EQ2J]}[
Clarissa : facebook = 0HA12zn)«EvJ	 twitter = V8I33KgQ2A!1
Brylee : facebook = V5ANeIp0|P	 twitter = 2)V]dHKpNU
Davina : facebook = VvGn1aT=TU	 twitter = `6F217TV«E
Rivka : facebook = OzOQ9]RI1	 twitter = fLKNR27I|
Cynthia : facebook = d.I1Qf«V81Q	 twitter = C.!11AB%9IG
Zaria : facebook = 0?XDCS0\L	 twitter = Y0SBEM$w2
Madalyn : facebook = ySXUg«Mebe0	 twitter = T#D5G;|SE]5
Paula : facebook = ÁVLnP«8V0	 twitter = SEDU-L00w
Salem : facebook = }V0pKQYS0	 twitter = pWR_4F@KD
Amelie : facebook = xJl-jXeCRU	 twitter = AU4VAat7«7
Madisyn : facebook = pM\JrRrkFlU	 twitter = T<R6BL|3T=+
Vienna : facebook = CUaUno_#QY	 twitter = 2AON'5h1PA
Haisley : facebook = T?VojE5*OvV	 twitter = `I2qAF$0AW2
Ainhoa : facebook = 1}+CV6XBiE	 twitter = kBP8A6O8I|
Journi : facebook = Q)A38.ECAt	 twitter = 6WxW5byEEL
Karter : facebook = YQZq6mYZo)	 twitter = %2vZADoXiL
Oaklee : facebook = LP'ZFb^N#6	 twitter = %gAcaLW0DD
Livia : facebook = 14nUMZ«U4	 twitter = X024WLSMf
Miley : facebook = xCE1TE9)F	 twitter = DBsL2esPX
Adele : facebook = zpI«bN8BQ	 twitter = Á|RAPL|B4
Amaia : facebook = bqxLpKYJS	 twitter = wmuCoBSQD
Yara : facebook = RZFNoqQ0	 twitter = M`YIFCl"
Averi : facebook = 4T1}D«vSI	 twitter = AC6CHS2dp
Emmeline : facebook = UY8Wc20Ety[I	 twitter = ,Q563L2AJY[a
Kyleigh : facebook = D5e7YW3NC18	 twitter = T07''VoHYpU
Princess : facebook = RBEyF]Q`}y6f	 twitter = QYI*rH!`}z6«
Penny : facebook = ?5PART2N:	 twitter = TwMDOs#,P
Sariyah : facebook = gGp2eCSeLAc	 twitter = 8X«f4ÁzH?IH
Amayah : facebook = fU&W0MTFt/	 twitter = P"G'SwLK1t
Crystal : facebook = {HY_Sl:O1V,	 twitter = EmZEQ0:T/4,
Keyla : facebook = 9FStYX]6W	 twitter = 3hD?NODxP
Lilyana : facebook = Smh4SPbjXkD	 twitter = 267!XWF0C6F
Linda : facebook = rcJOYjDO6	 twitter = yZXG11OJj
Aniya : facebook = 0s?M<SVKJ	 twitter = ENKFv7Xo-
Marianna : facebook = V1XT.?b_LV03	 twitter = KK&oH7P_eJeg
Alaiya : facebook = Q'MXmKF#40	 twitter = 2L10FZ-QY2
Noemi : facebook = mFABN/eaF	 twitter = .QH1I/E?X
Chanel : facebook = B5tJ«"9DB"	 twitter = Q#XG1Q4H}"
Estella : facebook = K}p$QCh«nHc	 twitter = Se`kWK3F72M
Isabela : facebook = -Op1iIMWdK2	 twitter = «pDSz{}XK13
Jillian : facebook = jsPrmG4CMaV	 twitter = mWM1CYAba2?
Kallie : facebook = GpPsDA`7Rn	 twitter = 1V<kVWU>m«
Ellianna : facebook = :2oQCFaBSoz1	 twitter = EyNQ_4LbO\s{
Elsa : facebook = PUHJsoxZ	 twitter = PlWAPbpV
Itzayana : facebook = F6+(V+N1YA03	 twitter = 8!Hxr1XXAnC0
Zora : facebook = I1RKSjBo	 twitter = J'GB7KaO
Estelle : facebook = 2DY]puI5GH=	 twitter = T2{]qCF«Jfp
Chana : facebook = YPNp]gfMD	 twitter = lj+LzOPKZ
Raina : facebook = t$O6PZTjJ	 twitter = ghSbAVVuD
Royal : facebook = 0SKwLdpAB	 twitter = 5GÁq1UWLA
Sunny : facebook = 4BH1FyZO?	 twitter = Ji^WDc`LL
Estrella : facebook = {P|L?lNy=jFS	 twitter = H}r!KB5Hah:S
Martha : facebook = }pu«MYBbJb	 twitter = ÁULKbYo6O"
Ellen : facebook = 8YISMWwj@	 twitter = jV«mKrBlV
Kailey : facebook = mW1z4IH3FN	 twitter = 83eBVZ5EU`
Maxine : facebook = Wl6LbX6Q1E	 twitter = OAmtk3YVIj
Clare : facebook = hMyYlgRXZ	 twitter = p1l2WRUIC
Teresa : facebook = 1L5_ZK!xBP	 twitter = aLeCw)AQGk
Annika : facebook = AU4!hgOiDA	 twitter = S$3dYC32OF
Kamilah : facebook = dLTo1Xu8EaJ	 twitter = ASsiVl*1ClH
Azariah : facebook = «L7fqN4*C+S	 twitter = W3$G_nqAcBO
Della : facebook = LWH6]Y]9H	 twitter = CEp3N,3WM
Addyson : facebook = SExL,xOy1tM	 twitter = )S8LS7J@e;A
Kai : facebook = SK«qH8K	 twitter = Á«SÁPMG
Lilianna : facebook = ;M^{UDUz(M54	 twitter = ;]KM+Ozh9R\M
Tinsley : facebook = oBEKgDk0chU	 twitter = f3#SWS0mPY&
Yaritza : facebook = a0E+qfIPKAq	 twitter = qYKNy|A+:xJ
Navy : facebook = D;L0.IER	 twitter = oBkWyCQR
Winnie : facebook = BDJMw4H8j@	 twitter = 2qTJJ;9IB@
Andi : facebook = qÁQ:BKPN	 twitter = hbMzK«AS
Kamiyah : facebook = Q40'XMlJ_nA	 twitter = 1Eq6PFKGm02
Waverly : facebook = TVL%ztFctvH	 twitter = bObQeV4OK'2
Sky : facebook = LZ6OR«5	 twitter = LMXWePg
Amaris : facebook = 7kT*BPWF1Á	 twitter = MVSCQ1r42.
Ramona : facebook = ;UU3D1E6F8	 twitter = ZEbWD2#hU8
Saoirse : facebook = «6pÁFrCÁG8J	 twitter = D7Q2BPn,dM,
Hana : facebook = B7r5D«IB	 twitter = QazLWJ«c
Judith : facebook = }nay«IGTYp	 twitter = D=Gb1yG0MB
Halle : facebook = gwLXDcDC7	 twitter = )f{HDWDaB
Laylah : facebook = cN#sqLMFZ.	 twitter = K2eORJEo4k
Novalee : facebook = Uer"+CDEG,y	 twitter = n?D2LÁEeSGa
Jaycee : facebook = jGgYYL}4vX	 twitter = IEXY133Kf@
Zaniyah : facebook = VG0v)_5R{«M	 twitter = uF5OTFzow@N
Alianna : facebook = -9(HM7)OAD4	 twitter = -QG1H;H9d2H
Paulina : facebook = D10M)LiZT@6	 twitter = Gyn,I4VVgwE
Jayde : facebook = ETN058KEz	 twitter = lHScMgL6«
Thalia : facebook = AIA-Qs,kW7	 twitter = MQNq;Evh.W
Giovanna : facebook = B0OIfgj$15«A	 twitter = V|u1Ptj62AGO
Gwen : facebook = Dm%6OORG	 twitter = EpJÁTbCL
Iliana : facebook = 5P«TA6iG_2	 twitter = TUM88Á1uDY
Elora : facebook = DvAANYkÁ(	 twitter = TVr.PGD,8
Ezra : facebook = s5U1NXCL	 twitter = SrrZZ!YC
Kaylie : facebook = Mw:HDKCp*5	 twitter = LxqY77DKI5
Braylee : facebook = 5WD%QVr>zNz	 twitter = SL%L'8Q>Ytp
Mavis : facebook = OViK9UShh	 twitter = 2FKZ-hEL?
Ellison : facebook = JgbHICy8Bq6	 twitter = Z?tMQC.E910
Margo : facebook = ,R$eVHcLT	 twitter = R7R_0EH0A
Mylah : facebook = S3VcqSlAA	 twitter = LnrVGLyHz
Paisleigh : facebook = 2ucMX«416LOf,	 twitter = wU2kNY6_DQ}6o
Analia : facebook = BKR4k\B16V	 twitter = m8F;FKyLH2
August : facebook = Y+g_GRP«k0	 twitter = xOiEP2P#Ah
Brittany : facebook = rB7dVu{^GGrH	 twitter = A9AYOA{1n5]h
Kaisley : facebook = SeR\D[X77fK	 twitter = ULM9lVZy03'
Belen : facebook = OK4VEt5S`	 twitter = o6xZ«SSF9
Promise : facebook = U19E=I?}9YD	 twitter = 9y&S=RKZ1$E
Amiya : facebook = FQJY0C5Ám	 twitter = oYJpXmhAE
Dalary : facebook = 2rKC«Ti9Ne	 twitter = Pp«Da!xoVZ
Veda : facebook = RC6HUmCx	 twitter = B/RM7«1M
Alisson : facebook = LXWu7Y5:i1Y	 twitter = =2GmFU2JP|3
Keilani : facebook = 1IT50E#F1H9	 twitter = YXl1oDZ9ÁVw
Oakleigh : facebook = i1J|<8F`UX@A	 twitter = HJa|NY'O8866
Guadalupe : facebook = S;nW8IY<]Y/yx	 twitter = Fl;4B*OJj932Q
Leanna : facebook = (3&eILQP!M	 twitter = hN6E*zIwBT
Rosalyn : facebook = (EqxHZtJyTr	 twitter = 265G9SaVWL7
Selene : facebook = bqYRDGVa@n	 twitter = LX3IR*89A2
Theodora : facebook = X21EO=@<#FÁT	 twitter = DCs2{gCN#bA0
Kamari : facebook = T:cIJF&H3u	 twitter = E4LUI2k59M
Anais : facebook = E^4h{HHHI	 twitter = 4RJ4laGCZ
Elodie : facebook = 3V"R0Z*QYk	 twitter = H*1W?.*FJO
Celia : facebook = PmzmVCzEB	 twitter = HiM5FQR7n
Dani : facebook = B6UEi<ZK	 twitter = n2JnUNFK
Hunter : facebook = S-v&Y1EJbN	 twitter = xmKNNZ>pxE
Indie : facebook = YuhPDYYy0	 twitter = Mz-CbWAW0
Kenia : facebook = pKH$}AJmL	 twitter = L8«EZSaa1
Nellie : facebook = S09E0B>Z?X	 twitter = fXRpkNPLgw
Belle : facebook = 0NrwNPDP9	 twitter = MoFA1PqwJ
Kataleya : facebook = gHitLP1T1C*;	 twitter = v1XCy.AT8F*;
Lexie : facebook = VjDA8cTuY	 twitter = JosIRlAB2
Miah : facebook = 6EZ!uQZX	 twitter = TBUZblY9
Rylan : facebook = aKV]kLLZg	 twitter = ea8NN[PZV
Sylvie : facebook = Z[1Zr+DAN2	 twitter = P[FXPA*az5
Valery : facebook = 3VMMm)LdzE	 twitter = PFFrSLm.14
Addilynn : facebook = 5ePA0iI«9Lms	 twitter = C4W#[R2||JK3
Dulce : facebook = Y|jASHonU	 twitter = BX;lGGurN
Marissa : facebook = 1_R?F1e(«HH	 twitter = 1X«w]D9P/J>
Meilani : facebook = R?1=msLJIMl	 twitter = v4Y7Z2JC0oB
Natasha : facebook = NN{H<fgXV{z	 twitter = 3O3\A«*AUo2
Jaylee : facebook = v-«:BSHgRd	 twitter = RRgBPjkX^j
Kimora : facebook = Á«$AZ$B0\K	 twitter = ZE$j«8P0\R
Raquel : facebook = UN&Q7FeÁ0R	 twitter = ^jYH2AHA|7
Scarlette : facebook = WoBpR[n2PpCm8	 twitter = W@PEB2%j-%7V3
Aliya : facebook = PtqB#VY0Q	 twitter = SholQFQR5
Nataly : facebook = %gCEsQP1«+	 twitter = RLVT!<xqCt
Whitney : facebook = qMB%3|gInVO	 twitter = =a2NW|vYMQ4
Corinne : facebook = Áq3CjUIFK1_	 twitter = fHKhÁFnnHK_
Denver : facebook = T=sJmAJS^m	 twitter = 3=^DVOy{YU
Nathalie : facebook = Fqi2H(C1QDe5	 twitter = WN$h34U7HqlY
Kiera : facebook = AAXu"1MyV	 twitter = KIÁL"VznP
Milana : facebook = qyMUWfySeL	 twitter = J3OBD[mzE1
Vada : facebook = ^I0HMÁBN	 twitter = XLwktVOG
Violeta : facebook = UE0&L.Á`KzB	 twitter = «AXg/8tCcX:
Luz : facebook = 0VEwYLU	 twitter = FBvDBkW
Addisyn : facebook = WD#Y'q61QA9	 twitter = 1:O>'2Y1AQR
Casey : facebook = :H8UAUh«7	 twitter = H/Yq«Cf2N
Deborah : facebook = mdH"«,TfL]I	 twitter = QH/pV,I41Y*
Tori : facebook = QiNLWAmd	 twitter = IvsMOSpM
Zainab : facebook = 5ycBKEHeKs	 twitter = h+IHAfZM&]
Erika : facebook = t"OdGRRQm	 twitter = BzG«ME2j0
Jenesis : facebook = Á0W9i9HKP9A	 twitter = F?DMj`q0iRT
Avalynn : facebook = RmKX01N"jIa	 twitter = DKKfsÁQxsSo
Nancy : facebook = &vKQEGv4T	 twitter = VH1SzfIQ]
Emmalynn : facebook = &WXH12KU8p@n	 twitter = 3X29CWxf`PLd
Hadlee : facebook = L1ODMS/[6z	 twitter = lVmL«I/rfF
Heavenly : facebook = 'l!UfSzHBGnw	 twitter = 3DLyjNd>OykP
Aubrielle : facebook = etL/CP{F/_M02	 twitter = 34<«y@S$/_UKI
Elisabeth : facebook = k0sAV<0*Mj6HS	 twitter = wK1I«<5U96aXn
Salma : facebook = F7AHO9>1C	 twitter = HVc9l«>PO
Adalee : facebook = !EA"97W«}W	 twitter = YKIR+ÁTdl2
Landry : facebook = Q2.qnKFRRj	 twitter = Mv.Y«2Z7Lu
Malayah : facebook = Ge0gC5BA-H\	 twitter = aV3rEHC11A\
Novah : facebook = @«4FL.«F^	 twitter = NbNYLJ8kv
Egypt : facebook = 3KT!OhrMN	 twitter = U9AÁAYGb5
Ayleen : facebook = S--«PDA6fp	 twitter = YEHB(X572.
Blessing : facebook = (D`WW11ft3EJ	 twitter = vQA7VP![B0.u
Elina : facebook = 4iNeLXdIA	 twitter = ZQ4T{H2Q1
Joyce : facebook = AGG1xDmMp	 twitter = «Cxx1nGXN
Myah : facebook = tKJHlQfE	 twitter = \{FHNZBf
Zoie : facebook = 1VjZZIGj	 twitter = X|OxOH6J
Christine : facebook = *1Á8PIL<A]8P$	 twitter = kY$yjtnAKRr,E
Jaelynn : facebook = V1T;ESh1Á3I	 twitter = 5CU;FWf_X7r
Persephone : facebook = A=-4CLcbÁ52X[Z	 twitter = 86z!I92WLbwnDB
Chandler : facebook = uCuSR_#9Qo|Z	 twitter = ,Dot1R#«O/C>
Emmaline : facebook = jAUSy>1H_jIs	 twitter = rqBx6YWACd,"
Paloma : facebook = _2ZYHLo<Q6	 twitter = VQnfz9Q4GW
Harleigh : facebook = XB_P3$]Of1Av	 twitter = ]kZ0}UA37DrS
Noor : facebook = HW[9S_YY	 twitter = Z«CrkLHÁ
Paola : facebook = gNDEze8ST	 twitter = F2BnSUKnq
India : facebook = GRP0E@5Ye	 twitter = KkOsH@PUq
Madalynn : facebook = EI?|,J5YP0wq	 twitter = #3?«,E0OsU8R
Rosalee : facebook = UVn1U5y64G«	 twitter = UGZh5xX6|tL
Florence : facebook = !B(6YL1A)0|G	 twitter = «O22vss/ZZxE
Maliah : facebook = h5Y/13ID«T	 twitter = 27LQY#5W1V
Flora : facebook = A+DAAk8D-	 twitter = vc«gObTZM
Luella : facebook = R.sVTEr|F:	 twitter = kPGu0MGI5u
Patricia : facebook = cIYx",7B'YZa	 twitter = UW0v0Cw«Á\w«
Whitley : facebook = OXcCÁB1z@:H	 twitter = «s8aEX6[X:V
Carolyn : facebook = OzW\B15n8VE	 twitter = M5J5O=5+GV"
Kathleen : facebook = LruD<RS0Dwr4	 twitter = XJlvuPM"oE<;
Keily : facebook = AsGEU\\jR	 twitter = yEIyRkÁCK
Kiana : facebook = \ARN=7X&X	 twitter = JHSHP[12Á
Tenley : facebook = Á«iddeJBAQ	 twitter = YUn5<2GQ&T
Alyson : facebook = zH-«TxE2T.	 twitter = NWYvgF4^J1
Barbara : facebook = ZZW|uKW?o@5	 twitter = 5PH0'G`5TgW
Dana : facebook = tXRuXFnS	 twitter = vYS2P>ES
Yasmin : facebook = pFI\lITGlm	 twitter = T0jFkwBP'O
Bexley : facebook = 5W8«vNUJeo	 twitter = wPEoI#x5BT
Micah : facebook = bLVkÁZLvT	 twitter = >XR«Q;cXb
Tatiana : facebook = KyKS0yrN<Iq	 twitter = ]L.ULs1Wf«r
Arden : facebook = thJUXPqC+	 twitter = U+2T1zCZD
Aubriella : facebook = ZH^?!WoOw8trF	 twitter = 5V1?HJ7g9^WI"
Lindsey : facebook = QÁv4Lim«FV8	 twitter = YudBFgSsdL7
Emani : facebook = CorZMSuI1	 twitter = fW19X&JWS
Hailee : facebook = ^AjLQZvO{[	 twitter = ^T7B1C18AN
Lisa : facebook = vRMAhMUx	 twitter = pR«ÁWvCZ
Sevyn : facebook = ?F5QL/OaA	 twitter = XFaQX324G
Fallon : facebook = OP20.1Q>ND	 twitter = >}Q70T\QCU
Magdalena : facebook = TB!Z8L{+$-6Ao	 twitter = nhTBFn8fs-G(S
Tinley : facebook = DOZY?]2PÁ1	 twitter = 7QnG3W4QsQ
Halo : facebook = QeQVtIWy	 twitter = UH9TO5J'
Lailah : facebook = w@KPPMh'wP	 twitter = -ASbM<tOVu
Arlette : facebook = l\dMCDZ`qwG	 twitter = F1qt«G^l(QW
Ansley : facebook = Bs9«UJ\W7}	 twitter = «PJÁK3\zNm
Esperanza : facebook = R@M>M_8N?2?7I	 twitter = +fWtWBW.?$n1H
Cleo : facebook = XSE-CugX	 twitter = CZe«aQT"
Aila : facebook = 25QMH*«G	 twitter = QfN`NIMj
Emerald : facebook = zGPWD;aN34y	 twitter = mUpW[QobLE0
Jaelyn : facebook = $ZP)_WhR5C	 twitter = w5v)V9ZLDV
Karlee : facebook = I%W0U@^[OZ	 twitter = 9IFA^DmgI-
Kaya : facebook = sDO*KXVb	 twitter = ,Rh*XCBE
Ingrid : facebook = Y1ORD4oX3|	 twitter = OUyggLx7CR
Jewel : facebook = Be2ZE7HmJ	 twitter = 6XNUaR7P'
Emilee : facebook = MNFi6]1C2L	 twitter = VXcX6zM'Z>
Giana : facebook = 2sDBtBNMt	 twitter = N3P(I9eBG
Paityn : facebook = ANL64$B`V"	 twitter = RU2t?6WHL"
Zola : facebook = P«ZP0J69	 twitter = TQAAMtt/
Amoura : facebook = Wi0ZBNkhhJ	 twitter = ZIig9NXbZ1
Renee : facebook = 2VF5NÁbEY	 twitter = DFDv"Z1Ti
Ann : facebook = cKcIAD«	 twitter = ZPYG4tO
Berkley : facebook = 7YtQ0GT>C|8	 twitter = 7V30PaKCbM1
Harriet : facebook = ZW12yF0VC)5	 twitter = J6EEkD|1Q28
Queen : facebook = LMkPxd7YZ	 twitter = «2S0O8BkG
Sariah : facebook = Bi3CLS1Kz8	 twitter = u9ZO|Y+Z2T
Beatrix : facebook = cz2iP1NSzMV	 twitter = uM7vS,7KKcA
Sandra : facebook = rCh«ZP8Wsf	 twitter = $0lT7«jXDH
Alannah : facebook = GSr3vKB31F%	 twitter = gMu6MsLZU91
Austyn : facebook = ÁnBJIB67|P	 twitter = S2faE4BHgB
Freyja : facebook = NUL!GA'85+	 twitter = C31DJH'cB+
Kaylin : facebook = 88OU«5QÁ)L	 twitter = ]VO7H8t%TK
Samira : facebook = EPZ}7YmC8h	 twitter = T41NOE=N21
Taliyah : facebook = J1xTkfJY=I6	 twitter = XOUO4-)g3zH
Hadleigh : facebook = E[uZ[)%ÁQTB5	 twitter = 27nY[ZR4YAp2
Kaiya : facebook = 25ND3X.RC	 twitter = sWZf9YYkK
Robin : facebook = 0-nOUuKOT	 twitter = OyiTPC3Q;
Luisa : facebook = *9IA2EKW4	 twitter = pHDTPLpx8
Zendaya : facebook = }ChAOwDM6n:	 twitter = kSWtt^1MRY:
Ariadne : facebook = f0TlhFZjEgW	 twitter = EVGD"e}I!e0
Dixie : facebook = <F6EsRBeO	 twitter = o9JUÁgEBY
